emoji player=ğŸ‘¤
emoji enemy=ğŸ’€
emoji friend=ğŸ‘¥
emoji treasure=ğŸ’°
emoji weapon=ğŸ—¡ï¸
emoji obstacle=ğŸš«
emoji key=ğŸ”‘
emoji door=ğŸšª
emoji powerup=âš¡
emoji flag=ğŸš©
emoji wizard=ğŸ§™
emoji dragon=ğŸ²
emoji skeleton=ğŸ’€
emoji zombie=ğŸ§Ÿ
emoji ghost=ğŸ‘»
emoji goblin=ğŸ‘º
emoji orc=ğŸ‘¹
emoji demon=ğŸ‘¿
emoji angel=ğŸ‘¼
emoji knight=ğŸ¤´
emoji queen=ğŸ‘¸
emoji king=â™”
emoji pawn=â™Ÿ
emoji bishop=â™—
emoji rook=â™–
emoji archer=ğŸ¹
emoji warrior=ğŸ—¡ï¸
emoji mage=ğŸ”®
emoji pirate=ğŸ´â˜ ï¸
emoji robot=ğŸ¤–
emoji alien=ğŸ‘½
emoji spaceship=ğŸš€
emoji star=â­
emoji moon=ğŸŒ•
emoji sun=â˜€ï¸
emoji cloud=â˜ï¸
emoji rain=ğŸŒ§ï¸
emoji snow=â„ï¸
emoji fire=ğŸ”¥
emoji water=ğŸ’§
emoji earth=ğŸŒ
emoji wind=ğŸ’¨
emoji tree=ğŸŒ³
emoji flower=ğŸŒ¸
emoji fruit=ğŸ
emoji vegetable=ğŸ¥¦
emoji meat=ğŸ¥©
emoji bread=ğŸ
emoji cake=ğŸ°
emoji pizza=ğŸ•
emoji sushi=ğŸ£
emoji ice cream=ğŸ¦
emoji coffee=â˜•
emoji tea=ğŸµ
emoji soda=ğŸ¥¤
emoji beer=ğŸº
emoji wine=ğŸ·
emoji cocktail=ğŸ¸
emoji whiskey=ğŸ¥ƒ
emoji book=ğŸ“š
emoji newspaper=ğŸ“°
emoji magazine=ğŸ“–
emoji letter=ğŸ’Œ
emoji envelope=âœ‰ï¸
emoji postcard=ğŸ“®
emoji phone=ğŸ“±
emoji computer=ğŸ’»
emoji television=ğŸ“º
emoji camera=ğŸ“·
emoji video game=ğŸ®
emoji music=ğŸµ
emoji movie=ğŸ¥
emoji sport=âš½
emoji ball=ğŸ€
emoji bat=ğŸ
emoji racket=ğŸ¾
emoji guitar=ğŸ¸
emoji drum=ğŸ¥
emoji microphone=ğŸ¤
emoji theater=ğŸ­
emoji ticket=ğŸ«
emoji clock=â°
emoji key=ğŸ”‘
emoji lock=ğŸ”’
emoji avocado=ğŸ¥‘
emoji bento box=ğŸ±
emoji biohazard=â˜£ï¸
emoji black hole=ğŸ•³ï¸
emoji blood type A=ğŸ…°ï¸
emoji blowfish=ğŸ¡
emoji bouquet=ğŸ’
emoji boxing glove=ğŸ¥Š
emoji brain=ğŸ§ 
emoji broken heart=ğŸ’”
emoji butterfly=ğŸ¦‹
emoji candle=ğŸ•¯ï¸
emoji chain=â›“ï¸
emoji chess knight=â™
emoji chili pepper=ğŸŒ¶ï¸
emoji chopsticks=ğŸ¥¢
emoji coffin=âš°ï¸
emoji computer mouse=ğŸ–±ï¸
emoji cricket game=ğŸ
emoji crystal ball=ğŸ”®
emoji door=ğŸšª
emoji dove=ğŸ•Šï¸
emoji dragon=ğŸ‰
emoji dress=ğŸ‘—
emoji eggplant=ğŸ†
emoji electric plug=ğŸ”Œ
emoji elephant=ğŸ˜
emoji exclamation question mark=â‰ï¸
emoji face with monocle=ğŸ§
emoji ferris wheel=ğŸ¡
emoji film projector=ğŸ“½ï¸
emoji fishing pole=ğŸ£
emoji floppy disk=ğŸ’¾
emoji fortune cookie=ğŸ¥ 
emoji fuel pump=â›½
emoji gear=âš™ï¸
emoji globe showing Asia Australia=ğŸŒ
emoji golf=ğŸŒï¸
emoji hibiscus=ğŸŒº
emoji hourglass done=âŒ›
emoji infinity=â™¾ï¸
emoji jack o lantern=ğŸƒ
emoji joystick=ğŸ•¹ï¸
emoji kiwi fruit=ğŸ¥
emoji leaf fluttering in wind=ğŸƒ
emoji lemon=ğŸ‹
emoji mahjong red dragon=ğŸ€„
emoji man artist=ğŸ‘¨ğŸ¨
emoji map of Japan=ğŸ—¾
emoji martial arts uniform=ğŸ¥‹
emoji microscope=ğŸ”¬
emoji motor scooter=ğŸ›µ
emoji mountain cableway=ğŸš 
emoji mountain railway=ğŸš
emoji musical keyboard=ğŸ¹
emoji musical score=ğŸ¼
emoji nail care=ğŸ’…
emoji oil drum=ğŸ›¢ï¸
emoji paintbrush=ğŸ–Œï¸
emoji party popper=ğŸ‰
emoji pencil=âœï¸
emoji pill=ğŸ’Š
emoji pirate flag=ğŸ´â˜ ï¸
emoji police car light=ğŸš¨
emoji poodle=ğŸ©
emoji postbox=ğŸ“®
emoji racing car=ğŸï¸
emoji radioactive=â˜¢ï¸
emoji recycle=â™»ï¸
